NO ./asset/wall.xpm42
SO ./asset/wall.xpm42
EA ./asset/wall.xpm42
WE ./asset/wall.xpm42

C 20,28,237
F 18,234,26

111111111111111111111
100000000000000000001
100000000000000000001
100001000000000000001
100000100000000000001
100000010000000000001
100000001000000000001
100000000W00000000001          111111
100000000000000000001          1000 1
100000000000000000001          111111
100000000001110000001
100011110000000000000
10001  10000010000001
100010010000000000001
111111111111111111111
