NO ./asset/scimitar.xpm42
SO ./asset/scimitar.xpm42
EA ./asset/scimitar.xpm42
WE ./asset/scimitar.xpm42

C 200,100,1
F 200,254,12

    11111111111111111111
111111100011100000000001
100000000000000000000001
100000000W00000011111111
111000000000011111
  1000110000001     
  1000100000001     
  1000100000001     
  1111111111111 