
NO ./asset/Armsy.xpm42
EA ./asset/RegularCannibals.xpm42
F 200,254,12
SO ./asset/Cowman.xpm42
WE ./asset/Virginia.xpm42
C 200,100,1


111111111111111111111111111111111111111111111111
100000000000000000000000000010000000000000000001
111111111111100111111111111010000000000000000001
100000000000000000000000000010000000000000000001
100000000000000000000000000010000000000000000001
100000000000000000000000000000000000000000000001         1111111
100000000000000000000000000000000000000000000001         1000001
10000000000000000000000N000000000000000000000001         1111111
100000000000000000000000000000000000000000000001
100000000000000000000000000000000000000000000001
100000000000000000000000000000000000000000000001
100000000000000000000000000000000000000000000001
100000000000000000000000000000000000000000000001
100000000000000000000000000000000000000000000001
100000000000000000000000000000000000000000000001
100000000000000000000000000000000000000000000001
111111111111111111111111111111111111111111111111
