NO ./include/maps/xpm/wood.xpm
SO ./include/maps/xpm/concrete1.xpm
EA ./include/maps/xpm/brick1.xpm
WE ./include/maps/xpm/rock.xpm
C 200,100,1
F 200,254,12

111111111111111111111111
10000000000000W000000111
110111000001111111110001
111111100001    1000001111
100000001001111110001111
111100000011101 10000101
111111111111111111111111
11