NO ./asset/Goblin.xpm42
SO ./asset/Goblin.xpm42
EA ./asset/Goblin_chathead.xpm42
WE ./asset/Goblin_chathead.xpm42

C 255,255,255
F 225,0,0

111111111111111
100000001001001
101010001S1100111111111
10000001110000000000001
11100001010000111111111
  1000010100011
11100111011101
10000100000101
10000111011101     111111111
1110000001111111111100000001
1111111111         111111111