NO asset/wall.xpm
SO asset/wall.xpm
EA asset/wall.xpm
WE asset/wall.xpm

C 1,230,210
F 220,123,24

11111111111111111111
11000100100010000011
11000101010001000011
11000010100001010011
11000001000000101011
11000101010001000011
11000100100010000011
11000100000101011011
11000010100010001011
11000101010000101011
11000100000101011011
11000010100010001011
11000101010000101011
11000100100010000011
11000101010001000011
11000010100001010011
11000001000000101N11
11111111111111111101
