NO asset/wall.xpm
SO asset/wall.xpm
EA asset/wall.xpm
WE asset/wall.xpm

C 1,230,130
F 220,123,24

1111111
1000001        111111
1000001111111  100001
1000000000001  100001
100000110000111100001
100000110000000000001
100000110000111100001
1000001100001  100001
1000N01100001  100001
111111111111111111111
