NO ./Wall1.xpm
SO ./Wall2.xpm
EA ./Wall1.xpm
WE ./Wall2.xpm

C 200, 100, 1
F 200, 255, 12


1111111111
1000000001 
100W001111
1000001011
1111111111